Become - становиться
Be - быть
Bite - кусать
Break - ломать
Blow - выдыхать
Build - строить
Buy - покупать
Do - делать
Drink - пить
Come - приходить
Drive - ездить
Draw - рисовать
Eat - есть
Feel - чувствовать
Fight - бороться
Fall - падать
Find - находить
Freeze - замерзать
Forgive - прощать
Forget - забывать
Fly - летать
Get - получать
Give - давать
Go - идти
Grow - расти
Hear - слышать
Hide - прятать
Have - иметь
Hit - ударять
Hold - удерживать
Hurt - ранить
Know - знать
Lay - класть
Lend - одалживать
Leave - покидать
Lead - руководить
Let - позволять
Light - освещать
Lie - лежать
Lose - терять
Make - делать
Meet - встречать
Put - ставить
Pay - платить
Read - читать
Ring - звонить
Ride - кататься
Run - бежать
Rise - вставать
Say - говорить
Seek - искать
See - видеть
Set - устанавливать
Send - отправлять
Shake - трясти
Shine - светить
Shut - закрывать
Shoot - стрелять
Sink - тонуть
Sing - петь
Sit - сидеть
Sleep - спать
Spend - тратить
Speak - говорить
Strike - ударять
Steal - красть
Stick - приклеивать
Swear - клясться
Sweep - мести
Swim - плавать
Take - брать
Teach - обучать
Tell - рассказывать
Tear - рвать
Throw - бросать
Think - думать
Wake - просыпаться
Wear - носить (одежду)
Write - писать