Agree - соглашаться
Ask - спрашивать
Answer - отвечать
Believe - верить
Borrow - занимать
Copy - копировать
Cook - готовить
Close - закрывать
Change - менять
Call - звонить
Carry - носить
Decide - решать
Explain - объяснять
Cry - кричать
Grip - схватить
Glow - светиться
Handle - управлять
Happen - случаться
Imagine - представлять себе
Improve - улучшаться
Impress - производить впечатление
Influence - воздействовать
Include - включать в себя
Increase - возрастать
Inform - уведомлять
Injure - ушибить
Inject - впрыскивать
Interest - интересовать
Invite - приглашать
Introduce - представлять
Irritate - возмущать
Join - связывать
Joke - шутить
Juggle - обманывать
Judge - судить
Jump - прыгать
Kill - убивать
Kick - пинать
Kiss - целовать
Knock - стучать
Knit - вязать
Knot - скреплять узлом
Label - навешивать бирку
Last - длиться
Laugh - смеяться
Level - выравнивать
License - разрешать
Lie - лгать
Listen - слушать
Like - нравиться
Live - жить
Look - смотреть
Lock - запирать
Long - желать
Love - любить
Manage - управлять
March - граничить
Marry - заключать брак
Matter - значить
Measure - измерять
Meddle - интересоваться
Memorize - запоминать
Melt - растворяться
Mend - чинить
Miss - потерпеть неудачу
Milk - доить
Mix - смешивать
Multiply - увеличивать
Muddle - перемешивать